R 640 480









NO ./textures/blue-sky.xpm
SO ./textures/wow.xpm
WE ./textures/maxresdefault.xpm
EA ./textures/wall640-2.xpm
S ./textures/barrel.xpm








F 0,0,0   	 	 	 	
C 128,128,0

1111111111        11111 1111     111111  111111 111111     
1000000001        1000111001     100001  1022011100001   
1000000001        1000000001     100001  1000000000001                  111
1000000001   111111000000001     100001  10000000000011111111           121
1002000001   100000000000001     100001  10000000000000000011           111
1000000001   111111000000001     100001  10000000000011111111   
1000000001        1000000001     100001  1000000000001
1000000001        1000000001     100001  1000000000001    
100000000111111111100000000111111100001111000000000001
100000000000000000000000000000000000000000000011110001111111111   
10000002000000000000000000000002000000000020001  10000000000001   
111100000000000000000000000000000000000000000011110000000000011    
   10000000000000000000001111111111100111111100000000000002001
   10000000000000000000001         1001     100000000000000001
   10000000000000000000001111111111100111  1100000000000000001
   10000000000000000000000000000200000001111000000000000020001
   10000000000W00000000000000000000002000000000000000000000001
   11111111111111111111111111111111111111111111111111111111111